31,31,31,31,31,31,31,31,31,31,31,31
31,2,2,31,31,31,31,31,31,35,2,31
31,31,31,31,31,31,31,31,31,31,31,31
31,31,31,31,31,2,2,31,31,31,31,31
31,31,31,31,31,31,31,31,31,31,31,31
31,2,2,31,31,31,31,31,31,2,2,31
31,31,31,31,31,31,31,31,31,31,31,31
7,13,19,25,9,37,23,30
