31,31,31,31,31,31,31,31,31,31,31,31
31,2,2,31,31,31,31,31,31,2,2,31
31,31,31,31,31,31,31,31,31,31,31,31
31,31,31,31,31,2,2,31,31,31,31,31
31,31,31,31,31,31,31,31,31,31,31,31
31,2,2,31,31,31,31,31,31,2,2,31
31,31,31,31,31,31,31,31,31,31,31,31
7,13,19,25,8,14,20,26