0,0,0,4,0,0,0,0,0,0,0,0
0,0,0,0,0,0,0,0,0,0,4,0
0,0,0,0,0,0,4,0,4,0,0,0
0,0,0,0,0,0,0,0,0,0,10,4
0,0,0,0,0,0,23,0,4,0,0,0
0,0,0,0,0,0,0,0,0,0,4,0
0,0,0,3,0,0,0,0,0,0,0,0