8,9,10,11,12,13,14,15,16,17,18,19
20,0,0,0,0,15,0,0,0,0,0,0
0,0,0,6,0,0,0,0,0,0,0,0
0,0,0,0,0,0,0,0,0,0,3,0
0,0,0,0,0,0,0,0,0,0,0,0
0,0,0,0,0,0,0,0,0,0,0,0
0,2,0,0,0,0,0,0,0,0,0,0