34,34,33,34,34,34,34,34,34,34,34,34
34,34,33,34,34,34,31,31,31,31,31,34
34,34,33,34,34,34,31,31,31,31,31,34
34,34,33,34,34,34,34,34,33,33,34,34
34,31,33,31,31,31,31,31,33,33,31,34
34,31,33,31,31,31,31,31,33,33,31,34
34,34,34,34,34,34,34,34,34,34,34,34
34,34,34,34,34,34,34,34,34,34,34,34