34,34,34,34,34,34,34,34,34,34,34,34
34,31,31,31,31,31,31,31,31,31,31,34
34,31,31,31,31,31,31,31,31,31,31,34
34,31,31,31,31,33,31,31,31,31,31,34
34,31,31,31,31,31,31,31,31,31,31,34
34,31,31,31,31,31,31,31,31,31,31,34
34,34,34,34,34,34,34,34,34,34,34,34
7,13,19,25,8,14,20,26