34,34,33,34,34,34,34,34,34,34,34,34
34,34,33,34,34,34,40,40,40,40,40,34
34,34,33,34,34,34,40,40,40,40,40,34
34,34,33,34,34,34,34,34,33,33,34,34
34,40,33,40,40,40,40,40,33,33,40,34
34,40,33,40,40,40,40,40,33,33,40,34
34,34,34,34,34,34,34,34,34,34,34,34
34,34,34,34,34,34,34,34,34,34,34,34