31,31,31,31,31,31,31,31,31,31,31,31
31,2,2,2,2,2,2,2,2,2,2,31
31,2,31,31,1,31,31,0,31,31,2,31
31,2,31,1,31,31,31,31,0,31,2,31
31,2,31,31,31,31,31,31,31,31,2,31
31,2,2,2,2,31,31,2,2,2,2,31
31,31,31,31,31,31,31,31,31,31,31,31
7,13,19,25,8,14,21,26,,,,