31,31,31,31,31,31,31,2,2,2,2,2
31,31,31,31,31,31,31,31,31,2,2,2
31,31,31,31,31,31,31,31,31,31,2,2
31,31,31,31,31,31,31,31,31,31,31,31
31,31,31,31,31,31,31,31,31,31,2,2
31,31,31,31,31,31,31,31,31,2,2,2
31,31,31,31,31,31,31,2,2,2,2,2
7,13,19,25,9,15,20,27,,,,