31,31,31,31,31,31,31,31,31,31,31,31
31,2,31,2,31,2,2,31,2,31,2,31
31,31,31,31,31,31,31,31,31,31,31,31
31,2,31,2,31,2,2,31,2,31,2,31
31,31,31,31,31,31,31,31,31,31,31,31
31,2,31,2,31,2,2,31,2,31,2,31
31,31,31,31,31,31,31,31,31,31,31,31
7,13,19,25,9,14,21,26