31,31,31,31,31,31,31,31,31,31,31,31
31,3,3,3,31,31,31,31,3,3,3,31
31,3,31,31,31,31,31,31,31,31,3,31
31,3,31,3,3,3,3,3,3,31,3,31
31,3,31,31,31,31,31,31,31,31,3,31
31,3,3,3,31,31,31,31,3,3,3,31
31,31,31,31,31,31,31,31,31,31,31,31
7,13,19,25,8,15,21,26