3,3,3,3,3,31,31,3,3,3,3,3
3,31,31,31,3,31,31,31,31,3,31,3
3,31,3,31,3,31,3,3,31,3,31,3
31,31,3,31,3,31,31,3,31,3,31,31
3,31,3,31,3,3,31,3,31,3,31,3
3,31,3,31,31,31,31,3,31,31,31,3
3,3,3,3,3,31,31,3,3,3,3,3
7,13,19,25,9,15,20,26,,,,