31,31,31,31,31,31,31,31,31,31,31,31
31,1,31,31,1,31,31,0,31,31,0,31
31,31,31,31,31,31,31,31,31,31,31,31
31,1,31,31,1,31,31,0,31,31,0,31
31,31,31,31,31,32,32,31,31,31,31,31
31,1,31,32,1,32,32,0,32,31,0,31
31,31,31,32,32,32,32,32,32,31,31,31
7,13,19,25,9,15,21,27