31,31,31,31,31,31,31,31,31,31,31,31
31,31,31,31,31,31,31,31,31,31,31,31
31,31,2,31,31,31,31,31,31,2,31,31
31,31,31,31,31,31,31,31,31,31,31,31
31,31,2,31,31,31,31,31,31,2,31,31
31,31,31,31,31,31,31,31,31,31,31,31
31,31,31,31,31,31,31,31,31,31,31,31
7,13,19,25,10,15,21,27